1111111111111111
10001000C0000001
100010000C0000P1
1111111111111111