1111111111111111
10001000C0000011
10010E00C0001P01
1111111111111111