11111111
1P0CCC11
100000E1
11111111