1111111111111111
11111111111P0111

11111111111111111