1111111111111111
1000000C00000001
100000000C0000P1
1111111111111111