11111111
1P0CC111
100000E1
11111111