111111111
100000001
1E0000001
1PCCCCCC1
111111111