1111111111111111
1000100000000011
100100E000C01P01
1111111111111111