1111111111111
1000000011111
1E00000001111
1PCCCCCC11111
1111111111111