11111
1P0C1
10011
111E1
11111
